l'Afrique - Africa
un africain - African
l'Allemagne - Germany
un allemand - German
l'Amérique - America
un américain - American
l'Argentine - Argentina
un argentin - an Argentine
l'Amérique centrale = Central America
l'Asie = Asia
un asiatique = Asian
le Brésil = Brazil
un brésilien = a brazilian
le Chili = Chile
un chilean = a Chilean
la Chine = China
un chinois = a Chinese
l'Amérique du Nord = North America
la Colombie = Columbia
un colombien = Columbien
la Corée = Korea
un coréen = a Corean
Cuba = Cuba
un cubain = a Cuban
l'equateur = Ecuador
un équatorien = an Ecuadorian
l'Espagne = Spain
un espagnol = a Spaniard
l'États-Unis = United States
l'Europe = Europe
un européen = European
l'Inde = India
un Indien = Indian
l'Italie = Italy
un italien = Italian
le Japon = Japan
un japonnais = Japanese
le mexique = Mexico
mexicain = Mexican
le Panama = Panama
panaméen = Panamanian
le Pérou  = Peru
péruvien = Peruvian
le Porto Rico = Puerto Rico
un portorican = Puerto Rican
le Russie = Russia
un russe = Russian
le Venezuela = Venezuela
Vénézuélien = Venezuelan
l'Amérique du Sud = South America