La famille = The family
l'épouse = wife
l'époux = husband
le frère = brother
la sœur = sister
le beau-frère = stepbrother
le demi-frère = halfbrother
le demi-soeur = halfsister
la fille = daughter
le fils = son
le beau-fils = stepson
la belle-fille = stepdaughter
le belle soeur = stepsister
les enfants = children
la belle-mère = stepmother
maman = mom
le beau-père = stepfather
le père = father
papa = dad
les parents = parents
marié = married
se marier = to get married
divorcé = divorced
séparé = separated
célibataire = single
le veuf = widower
le veuve = widow
l'amitié = friendship
l'amour = love
l'affection = affection
la jalousie = jealousy
la confiance = close friendship
tomber amoureux = to fall in love
se languir de = to miss someone
un petit ami = boyfriend
une petit copine = girlfriend